##########
#   . P  #
# O   .  #
#        #
#   O    #
#        #
##########