########
#  .. P#
# O    #
#    O #
########