########
#  .. P#
# OO   #
#      #
########